loot changes:
	add to dungeon/desert/jungle/mineshaft:
		blacker lotus(1-2)		Botania:blackLotus:1
		botania mana bottle		Botania:manaBottle
		red heart			TConstruct:heartCanister:1
		thaumium shovel			Thaumcraft:ItemShovelThaumium
		nitor				Thaumcraft:ItemResource:1
		alumentum			Thaumcraft:ItemResource
		leather(4-8)			minecraft:leather
		eyes of ender			minecraft:ender_eye
		sanitizing soap			Thaumcraft:ItemSanitySoap
		forestry saplings:
			cultivated pear
			almond
			ipe padauk
			grandadier's baobob
			pecan
			grapefruit
			coast sequoia
			acorn oak
			red maple
			blue mahoe
			hill cherry
			willow
			olive
			balsa
			desert acacia
			walnut
		crated items(1-3):
			obsidian		Forestry:cratedObsidian
			peat			Forestry:cratedPeat
			carrots			Forestry:cratedCarrots
			potatoes		Forestry:cratedPotatoes
			rubber			Forestry:cratedRubber
			fertilizer		Forestry:cratedFertilizer
			chestnut		Forestry:cratedChestnut
			mycelium		Forestry:cratedMycelium
			mulch			Forestry:cratedMulch
			charcoal		Forestry:cratedCharcoal
			
	add to mineshafts/villagesmith:
		steel helmet			Railcraft:armor.steel.helmet
		steel chestplate		Railcraft:armor.steel.plate
		steel leggings			Railcraft:armor.steel.legs
		steel boots			Railcraft:armor.steel.boots
		steel sword			Railcraft:tool.steel.sword
		steel axe			Railcraft:tool.steel.axe
		steel pick			Railcraft:tool.steel.pickaxe
		steel shovel			Railcraft:tool.steel.shovel
		bronze helmet			IC2:itemArmorBronzeHelmet
		bronze chestplate		IC2:itemArmorBronzeChestplate
		bronze leggings			IC2:itemArmorBronzeLegs
		bronze boots			IC2:itemArmorBronzeBoots
	
	remove from all:
		mundane ring			Thaumcraft:ItemBaubleBlanks:1
		mundane belt			Thaumcraft:ItemBaubleBlanks:2
		mundane amulet			Thaumcraft:ItemBaubleBlanks
		vis stone(amulet)		Thaumcraft:ItemAmuletVis
		thaumiun hoe			Thaumcraft:ItemHoeThaumium
		
	remove from all (except bonus)
		ChC lexicon			ChromatiCraft:chromaticraft_item_help
		botania lexicon			Botania:lexicon
		BOP wading boots		BiomesOPlenty:wadingBoots
		BOP flippers			BiomesOPlenty:flippers
		
	change amounts:
		enchanter's phials: 8-24	Automagy:phialExtra
		
	change weights:
		IC2 iridium shard-lower			IC2:itemShardIridium
		common treasure bags-increase		Thaumcraft:ItemLootBag
		uncommon treasure bags-increase		Thaumcraft:ItemLootBag:1
		rare treasure bags-increase		Thaumcraft:ItemLootBag:2





forestry saplings:
-----------------------
cultivated pear		extratrees.species.pear
almond			extratrees.species.almond
ipe 			forestry.treeIpe
padauk			forestry.treePadauk
grandadier's baobob	forestry.treeBaobab
pecan			extratrees.species.pecan
grapefruit		extratrees.species.grapefruit
coast sequoia		forestry.treeSequioa
acorn oak		forestry.treeOak
red maple		extratrees.species.redmaple
blue mahoe		forestry.treeMahoe
hill cherry		forestry.treeCherry
willow			forestry.treeWillow
olive			extratrees.species.olive
balsa			forestry.treeBalsa
desert acacia		forestry.treeAcacia
walnut			forestry.treeWalnut